ACTGTAACGCG: CTGTAACGCG
TCATCTTATTT: CATCTTATTT
GAGAACAGGAA: AGAACAGGAA
ATTTTGGACTC: TTTTGGACTC
CGCCCCTCGGA: GCCCCTCGGA
GAGTTTGGTTG: AGTTTGGTTG
CACCTTATTGA: ACCTTATTGA
AGTCTCGGCGG: GTCTCGGCGG
CTAGACCCGTT: TAGACCCGTT
CGCTTTTTAGG: GCTTTTTAGG
GGTCAAAGGGG: GTCAAAGGGG
CAGGCGGATCG: AGGCGGATCG
CGGGGTCTTGT: GGGGTCTTGT
TGCGTTCACTG: GCGTTCACTG
CTCTCGGTCAG: TCTCGGTCAG
GACCAAAATGG: ACCAAAATGG
CCACTTCTGCT: CACTTCTGCT
GATTCTCCGCC: ATTCTCCGCC
TGGGACGAACC: GGGACGAACC
CCGTGTTTGAC: CGTGTTTGAC
CAAAACTCTCG: AAAACTCTCG
GTAAGAAGAGT: TAAGAAGAGT
TTAGAGTGCCG: TAGAGTGCCG
TTATTGACGGA: TATTGACGGA
ACCTTCAAACT: CCTTCAAACT
TGTGACGAGAA: GTGACGAGAA
ACGGCCGTCCG: CGGCCGTCCG
GGGCCCATGGC: GGCCCATGGC
CAGCTGTCAAG: AGCTGTCAAG
GAGCTACAATC: AGCTACAATC
GGTCGGTCGGA: GTCGGTCGGA
TTAGTGACAGA: TAGTGACAGA
TGAGGTCTCGA: GAGGTCTCGA
CAATAGTTAGT: AATAGTTAGT
TTAGGTGATTA: TAGGTGATTA
TCTTATTTAAA: CTTATTTAAA
TTGGTTGAATG: TGGTTGAATG
CTCGGAAGACC: TCGGAAGACC
GGGACCCGGCG: GGACCCGGCG
TAGAGAACAGG: AGAGAACAGG
AACCTTCAAAC: ACCTTCAAAC
GACCCCGGGCC: ACCCCGGGCC
GTGTAAGGCCC: TGTAAGGCCC
TGGAGCTTGAG: GGAGCTTGAG
AAGAATCCTTA: AGAATCCTTA
TGTAAGGCCCA: GTAAGGCCCA
ATTTATGATGG: TTTATGATGG
GGTCTACGGGC: GTCTACGGGC
CTCCTGTAGAA: TCCTGTAGAA
TTAAAATATGG: TAAAATATGG
GCGGCTTAGCT: CGGCTTAGCT
GTGCCGGTCCC: TGCCGGTCCC
TACGATATCGG: ACGATATCGG
GGTCCTGGGAC: GTCCTGGGAC
AAACGTGTAGG: AACGTGTAGG
AGAGAATTTTC: GAGAATTTTC
AGAGTCGCGGA: GAGTCGCGGA
GATACTCTCGA: ATACTCTCGA
GGGTCTTGTTC: GGTCTTGTTC
TGGCCCACTAG: GGCCCACTAG
CTTTTAGGTGA: TTTTAGGTGA
AGAAGGTGGGT: GAAGGTGGGT
AATCTGACCCC: ATCTGACCCC
GTTTATCCTTA: TTTATCCTTA
TGCCTGCGTTC: GCCTGCGTTC
GGGAATTTTAG: GGAATTTTAG
GTGACAGATCA: TGACAGATCA
AGGACCTAATA: GGACCTAATA
ACGTACATTGT: CGTACATTGT
CCGGAGTGACG: CGGAGTGACG
AATACGATATC: ATACGATATC
TAAAATATGGA: AAAATATGGA
TGTTCGGATTC: GTTCGGATTC
ATTGCCGGTAA: TTGCCGGTAA
GCAGGGATTTT: CAGGGATTTT
TCCCAAACATA: CCCAAACATA
CGACCTGTCCG: GACCTGTCCG
TTTAAAATATG: TTAAAATATG
ATGGCAGCTAG: TGGCAGCTAG
CAGGCTCAAGG: AGGCTCAAGG
CCAATAGTTAG: CAATAGTTAG
AATGGTGTGCG: ATGGTGTGCG
GAGTGCAGTCG: AGTGCAGTCG
TTAGGAGTTTG: TAGGAGTTTG
GCGATCGTTCC: CGATCGTTCC
TTGAGTGATAT: TGAGTGATAT
TGTATGCCATC: GTATGCCATC
TTCATGGCAGC: TCATGGCAGC
AAGTGAGAGAG: AGTGAGAGAG
TCTGCAGTAAT: CTGCAGTAAT
GGACGAACCAG: GACGAACCAG
CCATCCAGAGT: CATCCAGAGT
TCCGGATACTC: CCGGATACTC
AGACACTCAGG: GACACTCAGG
CAGAAGCTATT: AGAAGCTATT
AACTCATTTTG: ACTCATTTTG
CCGTTCGATTG: CGTTCGATTG
AATAACCAAAC: ATAACCAAAC
CCTTGTTAGAC: CTTGTTAGAC
GTTGTTTAGCG: TTGTTTAGCG
GAGGGGCGCTT: AGGGGCGCTT
GCTGCAGACCC: CTGCAGACCC
ATCTTATTTAA: TCTTATTTAA
CATGCCACCTT: ATGCCACCTT
GGTTCCTTAAT: GTTCCTTAAT
ACTAGCCCTTT: CTAGCCCTTT
GATCGGATTCT: ATCGGATTCT
GCTAGAGCAAC: CTAGAGCAAC
AGTGCCACTCC: GTGCCACTCC
GTGAGTTCCTT: TGAGTTCCTT
ACGATATCGGT: CGATATCGGT
TAGGGGGCACG: AGGGGGCACG
ATCTGACGTCC: TCTGACGTCC
CATCCAGAGTA: ATCCAGAGTA
CCGCCTTGGAC: CGCCTTGGAC
ATCTCCGTCGA: TCTCCGTCGA
CACAAAGAATC: ACAAAGAATC
CGGGGAAATAG: GGGGAAATAG
TTAGGGGGCAC: TAGGGGGCAC
GGAAGATTAAC: GAAGATTAAC
CGCATTACAGA: GCATTACAGA
AAAACAATTAA: AAACAATTAA
CCAGTGCCACT: CAGTGCCACT
GTAGGATCGGA: TAGGATCGGA
AGCTAGACACT: GCTAGACACT
AATAATACGAT: ATAATACGAT
CAAAATGGTCG: AAAATGGTCG
TACTACTCGTA: ACTACTCGTA
ACGAGGACCTA: CGAGGACCTA
CACTCCAATAG: ACTCCAATAG
CGCCTTGGACC: GCCTTGGACC
TTAGCTGACTG: TAGCTGACTG
TGCCATCTTAA: GCCATCTTAA
TACGTGTAGGA: ACGTGTAGGA
GGCATGCCACC: GCATGCCACC
CTTATTTAAAA: TTATTTAAAA
GTAGATCTCCG: TAGATCTCCG
TCACTGCCCGT: CACTGCCCGT
CCGCTTTTCGA: CGCTTTTCGA
GCCAAATCTGA: CCAAATCTGA
TTAGGGCAGCG: TAGGGCAGCG
AAACAGGGTCC: AACAGGGTCC
GTAATCCGGCA: TAATCCGGCA
CGTTCATGGCA: GTTCATGGCA
TCCTTAGCTGA: CCTTAGCTGA
CCAAATCTGAC: CAAATCTGAC
ATCTCCTGTAG: TCTCCTGTAG
AGGGGTTGATA: GGGGTTGATA
ACGGTCAAAGG: CGGTCAAAGG
CACGGACAGAC: ACGGACAGAC
CACCCTCGGGG: ACCCTCGGGG
AATAGCAAGGT: ATAGCAAGGT
AAGGTAGTTTA: AGGTAGTTTA
GTATCGGGCTC: TATCGGGCTC
GGCACGAACTT: GCACGAACTT
TCATGGCAGCT: CATGGCAGCT
CTTAGCTGACT: TTAGCTGACT
TACCGCACTAG: ACCGCACTAG
TGGACCTCCGT: GGACCTCCGT
TGATAACGTTG: GATAACGTTG
ACCATCCAGAG: CCATCCAGAG
GGCCCAGCGTG: GCCCAGCGTG
TCTACGGGCCG: CTACGGGCCG
GCGCCAGGTCT: CGCCAGGTCT
ACTGAGGTCTC: CTGAGGTCTC
GCCCGTTCGAT: CCCGTTCGAT
AACAAGCAGAT: ACAAGCAGAT
AAGGCACCGGG: AGGCACCGGG
ATCTGTCACCC: TCTGTCACCC
CCCTCGGGGTT: CCTCGGGGTT
CAGACCCACTT: AGACCCACTT
TCACAAAGAAT: CACAAAGAAT
TTTCGACTGGA: TTCGACTGGA
TGAGACAAGGA: GAGACAAGGA
GACAGTGCAGC: ACAGTGCAGC
ACCGCCTTGGA: CCGCCTTGGA
ATTAACGGACT: TTAACGGACT
GACAGGTTCCT: ACAGGTTCCT
GATGGCACGGG: ATGGCACGGG
ACGAGAAGGGG: CGAGAAGGGG
GTCCGCGCGCC: TCCGCGCGCC
GCTTAGTCCGA: CTTAGTCCGA
GACTAGCCCTT: ACTAGCCCTT
CTACAACAGCT: TACAACAGCT
CTTCCAGCGAG: TTCCAGCGAG
TATGATGGACG: ATGATGGACG
GATATCGGTGT: ATATCGGTGT
TACTGCCATAA: ACTGCCATAA
ACGGACAGACT: CGGACAGACT
CGGTCATTGAT: GGTCATTGAT
GTCCTGGGACG: TCCTGGGACG
TCGAATCGCAT: CGAATCGCAT
TTGGACCTCCG: TGGACCTCCG
TACCGACGACC: ACCGACGACC
GCTTAGCTCAG: CTTAGCTCAG
ACCCAGGCGGA: CCCAGGCGGA
CCAAAACTCTC: CAAAACTCTC
AACTCGGGACG: ACTCGGGACG
TGACTGTAACG: GACTGTAACG
CCCAGGGAGGT: CCAGGGAGGT
GCAAATGGACA: CAAATGGACA
CGGAGGGCTAC: GGAGGGCTAC
GTCCTGAGACA: TCCTGAGACA
TGGGTAGACCA: GGGTAGACCA
TAACAACTCAT: AACAACTCAT
CAGGGAGGTCG: AGGGAGGTCG
CCGGCACCGCC: CGGCACCGCC
GAGAGGGGTTG: AGAGGGGTTG
GGCCGTCCGCC: GCCGTCCGCC
TGCCGGTAAGC: GCCGGTAAGC
AAGAAGGTGGG: AGAAGGTGGG
GGAGCTTGAGT: GAGCTTGAGT
GAACTTCCCTC: AACTTCCCTC
GTAGACCACCC: TAGACCACCC
TCGATCATCTT: CGATCATCTT
CAGGTTAGAGT: AGGTTAGAGT
TTGGACTCCAG: TGGACTCCAG
CAAGGATCACT: AAGGATCACT
CTTGAGTGATA: TTGAGTGATA
TTAACGGACTT: TAACGGACTT
TCGGATTCCAT: CGGATTCCAT
GCCGCAGAAGC: CCGCAGAAGC
GGACCCGGCGG: GACCCGGCGG
AAGCAGATAGC: AGCAGATAGC
CAAACTCGGGA: AAACTCGGGA
CCAGAACCCCA: CAGAACCCCA
GCCCTTGTTAG: CCCTTGTTAG
AGTTACCATAA: GTTACCATAA
TTCAAACTCAA: TCAAACTCAA
CTTTTGTAATC: TTTTGTAATC
ATAATGAAATT: TAATGAAATT
GCGGGCCAAAT: CGGGCCAAAT
TTCTGCGCTAT: TCTGCGCTAT
CGGCGGCTTAG: GGCGGCTTAG
GCCGGTCCCTC: CCGGTCCCTC
CGCCGTGTTTG: GCCGTGTTTG
CAGGTCTGTAT: AGGTCTGTAT
GGTCGAGACAA: GTCGAGACAA
ATAACAACTCA: TAACAACTCA
TACGGGCCGCG: ACGGGCCGCG
GGGGGCAGACG: GGGGCAGACG
TAATCTGACCC: AATCTGACCC
AAAATATGGAG: AAATATGGAG
CCGCACTAGCC: CGCACTAGCC
GGTAGACCACC: GTAGACCACC
ATCTCGAGGAA: TCTCGAGGAA
TGAATCCGCCA: GAATCCGCCA
CATACCGCACT: ATACCGCACT
TTTGCCGCAGA: TTGCCGCAGA
GCCACCTTATT: CCACCTTATT
GCCCCTCGGAA: CCCCTCGGAA
AATACCCAGGC: ATACCCAGGC
ATCATCTTATT: TCATCTTATT
CAAAGGGGCTT: AAAGGGGCTT
TAGTTTATCCT: AGTTTATCCT
CTCAAGGCACC: TCAAGGCACC
TTCAGCCTTCC: TCAGCCTTCC
TTTTTAGGCTA: TTTTAGGCTA
CCACCTGCAGG: CACCTGCAGG
TGGTGTGCGCC: GGTGTGCGCC
GGTGAGTTCCT: GTGAGTTCCT
CGGCACCGCCT: GGCACCGCCT
TCGCGGATGGC: CGCGGATGGC
AACGTTGAATA: ACGTTGAATA
AGAATTTTCGA: GAATTTTCGA
CTCTCGATGAC: TCTCGATGAC
ATAACGTTGAA: TAACGTTGAA
AACTGAATCCG: ACTGAATCCG
GACTATTGACA: ACTATTGACA
CTGCCATAATC: TGCCATAATC
GCTTTTTAGGC: CTTTTTAGGC
TGAGTTCCTTT: GAGTTCCTTT
CGGTCAAAGGG: GGTCAAAGGG
GTCGCGGATGG: TCGCGGATGG
CCTGCAGGGAT: CTGCAGGGAT
CGTGTAGGATC: GTGTAGGATC
GCCCAGCGTGG: CCCAGCGTGG
AACGGCCGTCC: ACGGCCGTCC
TAAGAATGCCG: AAGAATGCCG
CGATCTCTTCA: GATCTCTTCA
CAACCTTCAAA: AACCTTCAAA
TCACCCCACCT: CACCCCACCT
TTATAGACGGT: TATAGACGGT
TCCGCCCGTTC: CCGCCCGTTC
GGATACTCTCG: GATACTCTCG
TGTTAGACACG: GTTAGACACG
TGTATCTGACG: GTATCTGACG
AAATACTACAA: AATACTACAA
ATCGGGCTCCT: TCGGGCTCCT
AGCTGTCAAGG: GCTGTCAAGG
AAATGGACAAT: AATGGACAAT
CTGACGAAACA: TGACGAAACA
ACAGCCTGCAA: CAGCCTGCAA
AGGGCAGCGTC: GGGCAGCGTC
CATCTTAAAAA: ATCTTAAAAA
CGGCTTAGCTC: GGCTTAGCTC
TTCCAGCGAGA: TCCAGCGAGA
ACAATTAATCT: CAATTAATCT
CCGGTAAGCTT: CGGTAAGCTT
AGAACCAAAAC: GAACCAAAAC
GATAGAGAACA: ATAGAGAACA
GGTCTCGATAG: GTCTCGATAG
ATGCTCAAGGC: TGCTCAAGGC
GTGTAGGATGG: TGTAGGATGG
TCATGAAATGT: CATGAAATGT
GGTGGGTAGAC: GTGGGTAGAC
AGCCATAACAG: GCCATAACAG
GAACCAGCAAA: AACCAGCAAA
CGAGTGGGAAT: GAGTGGGAAT
CTCATACCGCA: TCATACCGCA
TTCGGATTCCA: TCGGATTCCA
CATACAGGGAC: ATACAGGGAC
GGTTACGTGTA: GTTACGTGTA
GCCCGTCCCGA: CCCGTCCCGA
TCTGAATCTAC: CTGAATCTAC
TCAGCCTTCCA: CAGCCTTCCA
CAGATAGCTAT: AGATAGCTAT
GGTACACCGGG: GTACACCGGG
AGACAACGCCC: GACAACGCCC
CTACTCGTAAC: TACTCGTAAC
CAAGAAACTCG: AAGAAACTCG
CAAACTCAAGT: AAACTCAAGT
AGGTTAGAGTG: GGTTAGAGTG
TAGTGTAAGGC: AGTGTAAGGC
AGACTATTGAC: GACTATTGAC
CGAGACAACGC: GAGACAACGC
GGGGCACCCTC: GGGCACCCTC
TAGTGACAGAT: AGTGACAGAT
CGAGGAAGTGA: GAGGAAGTGA
GATTAACGGAC: ATTAACGGAC
CATCATACAGG: ATCATACAGG
GTCGAGACAAC: TCGAGACAAC
TGACAGATCAA: GACAGATCAA
GGGTTTAGGAG: GGTTTAGGAG
GAGACCATCCA: AGACCATCCA
AGGGACTGGTC: GGGACTGGTC
GGAGGGCTACT: GAGGGCTACT
AACAATTAATC: ACAATTAATC
ATTCCATTGAT: TTCCATTGAT
GATTGCCGGTA: ATTGCCGGTA
AGTGGTCGACC: GTGGTCGACC
CTCGCTAAGAA: TCGCTAAGAA
TAACGTTGAAT: AACGTTGAAT
TGTCACCCCCA: GTCACCCCCA
GAAGCTGCAGA: AAGCTGCAGA
ACAAGGATCAC: CAAGGATCAC
AGCTAGAGCAA: GCTAGAGCAA
AAGACCACATT: AGACCACATT
GCAGCTGTCAA: CAGCTGTCAA
TCGTAGGGGCA: CGTAGGGGCA
CGTGTTTGACT: GTGTTTGACT
GGGCTTAGTCC: GGCTTAGTCC
CGCCAAATGGC: GCCAAATGGC
CTGAATCCGCC: TGAATCCGCC
GAGGACCTAAT: AGGACCTAAT
ATGTCCCAAGG: TGTCCCAAGG
TGCGCTATCGG: GCGCTATCGG
GATCTCTTCAT: ATCTCTTCAT
CAGTCGTCCTG: AGTCGTCCTG
CGGCCGTCCGC: GGCCGTCCGC
ACCAGAACCCC: CCAGAACCCC
GGACAGACTAC: GACAGACTAC
TAAGTTCAGCC: AAGTTCAGCC
TTTATCCTTAG: TTATCCTTAG
GACTCCAGCTA: ACTCCAGCTA
TTTACCCCGGG: TTACCCCGGG
CCTGTCCGCTT: CTGTCCGCTT
GGCTTAGCTCA: GCTTAGCTCA
GCCGCTCTCGT: CCGCTCTCGT
CTCGAGTTTAT: TCGAGTTTAT
ATTATAACCTG: TTATAACCTG
TTAGACACGAG: TAGACACGAG
CCTTAGTGTAA: CTTAGTGTAA
CGGGCCAAATC: GGGCCAAATC
GGCTCCTGCGC: GCTCCTGCGC
CCAGAGTATCG: CAGAGTATCG
GTCTTGTTCGG: TCTTGTTCGG
CAGCAAAATAC: AGCAAAATAC
GAACCAAAACT: AACCAAAACT
AGCTACAATCA: GCTACAATCA
GATCACCCCAC: ATCACCCCAC
ACACCGGGGAA: CACCGGGGAA
ACTCTCGGTCA: CTCTCGGTCA
TCTGGGCATGG: CTGGGCATGG
CTTCAAACTCA: TTCAAACTCA
TATCGGTGTAT: ATCGGTGTAT
ATGGCCCACTA: TGGCCCACTA
ACAGGTTCCTT: CAGGTTCCTT
GACGGTAAAGT: ACGGTAAAGT
CAGGGACCAAA: AGGGACCAAA
CTTGTTAGACA: TTGTTAGACA
TCTCCGCCCGT: CTCCGCCCGT
GGAAGAAGGTG: GAAGAAGGTG
ATTGATCACCC: TTGATCACCC
GGGTCTACGGG: GGTCTACGGG
CATTACAGAGA: ATTACAGAGA
AACCAGCAAAA: ACCAGCAAAA
CTGCTTGGTTG: TGCTTGGTTG
GTAGGATGGGG: TAGGATGGGG
CGATCACAAAG: GATCACAAAG
GCACCGCCCGA: CACCGCCCGA
CAGAACCCCAG: AGAACCCCAG
AAATGGCACGA: AATGGCACGA
GGCTCAAGGTT: GCTCAAGGTT
TAAGAAGAGTC: AAGAAGAGTC
ACACTCAGGCT: CACTCAGGCT
ATCACTGAGGT: TCACTGAGGT
ATCCTTAGCTG: TCCTTAGCTG
TAGCAAGGTAC: AGCAAGGTAC
CTATGCACCGC: TATGCACCGC
AAGCTATTATA: AGCTATTATA
TTCCTTAATAC: TCCTTAATAC
ATTATTAGTGA: TTATTAGTGA
TAAAAACAATT: AAAAACAATT
CTGTGACGAGA: TGTGACGAGA
GTTCCTTAATA: TTCCTTAATA
AGACCCGTTGA: GACCCGTTGA
CTCGTAACGCA: TCGTAACGCA
TAACGCATCAT: AACGCATCAT
TTCATGAAATG: TCATGAAATG
ACCAGCAAAAT: CCAGCAAAAT
CGCCCGTTCGA: GCCCGTTCGA
CGCAGAAGCTA: GCAGAAGCTA
GCCCAGCGAGT: CCCAGCGAGT
CCCGTCCCGAA: CCGTCCCGAA
TGAAATTTATG: GAAATTTATG
ACGGACTTAGA: CGGACTTAGA
CACCCGGTAGA: ACCCGGTAGA
CGGGCTCCTGC: GGGCTCCTGC
TTTGGTTGTTT: TTGGTTGTTT
TCGAGACAACG: CGAGACAACG
CGCTCTCGTAG: GCTCTCGTAG
GACTTAGAATA: ACTTAGAATA
AAGGGGCTTAG: AGGGGCTTAG
CAAAACGTGTA: AAAACGTGTA
CTCTGAATCTA: TCTGAATCTA
GTTCGGATTCC: TTCGGATTCC
TCGAGGAAGTG: CGAGGAAGTG
CTCGATGACCA: TCGATGACCA
CGTTGACAGGT: GTTGACAGGT
CTTAGCTCAGG: TTAGCTCAGG
GTGTAGGATCG: TGTAGGATCG
TATGTGCTTCT: ATGTGCTTCT
TTAATACCCAG: TAATACCCAG
GAGTCATAATG: AGTCATAATG
ACCACCCGGTA: CCACCCGGTA
TGGACTCCAGC: GGACTCCAGC
GGATCGGATTC: GATCGGATTC
GGGCTCCTGCG: GGCTCCTGCG
AAGAATGCCGG: AGAATGCCGG
CGGGTCTACGG: GGGTCTACGG
GCTACTGCCAT: CTACTGCCAT
GCTACAATCAT: CTACAATCAT
GCCCATGGCCC: CCCATGGCCC
GTTCGATTGCC: TTCGATTGCC
GTCGATTTAGG: TCGATTTAGG
TGAAATGTCCC: GAAATGTCCC
AGAGGGGCGCT: GAGGGGCGCT
TCACTGAGGTC: CACTGAGGTC
GAATTTTCGAC: AATTTTCGAC
ACAATCATGTA: CAATCATGTA
AGTGTAAGGCC: GTGTAAGGCC
GCCCGCAGCGA: CCCGCAGCGA
CGCCCGCAGCG: GCCCGCAGCG
ATTTAGGGCAG: TTTAGGGCAG
TCGCATTACAG: CGCATTACAG
ATAGACGGTAA: TAGACGGTAA
ATGTGCTTCTC: TGTGCTTCTC
GTGGGAATTTT: TGGGAATTTT
CTTAGTCCGAC: TTAGTCCGAC
CGTAACGCATC: GTAACGCATC
AGAAGAGTCGC: GAAGAGTCGC
TGCCGCAGAAG: GCCGCAGAAG
GACCAGAACCC: ACCAGAACCC
ATCATGTAGCC: TCATGTAGCC
GGCAGACGGTC: GCAGACGGTC
TCCGATCACAA: CCGATCACAA
CCGTGTAGGTG: CGTGTAGGTG
CGCCGCTCTCG: GCCGCTCTCG
AGGGACCCGGC: GGGACCCGGC
TAGAGCAACCG: AGAGCAACCG
TAACAGGTTCT: AACAGGTTCT
AGATCTCCGTC: GATCTCCGTC
CGAGTGCAGTC: GAGTGCAGTC
ATGCACCGCCC: TGCACCGCCC
AGTTTATGTAA: GTTTATGTAA
GGGACCAAAAT: GGACCAAAAT
AGAGTGCCGGT: GAGTGCCGGT
TGAGGTAGAGC: GAGGTAGAGC
CGCAGCGAGCT: GCAGCGAGCT
GGACGAGGACC: GACGAGGACC
ATGAAATTTAT: TGAAATTTAT
GGTAGATCTCC: GTAGATCTCC
TTATAACCTGG: TATAACCTGG
TATTGACGGAG: ATTGACGGAG
ACAGCTCGGTC: CAGCTCGGTC
TGCCGGTCCCT: GCCGGTCCCT
CCAGAGGGGCG: CAGAGGGGCG
AGAGCAACCGA: GAGCAACCGA
CGACAAGCCCC: GACAAGCCCC
CGAGTTTATGT: GAGTTTATGT
GAGTCGCGGAT: AGTCGCGGAT
CTCCGTCGAAC: TCCGTCGAAC
CGTTCACTGCC: GTTCACTGCC
GATTGATGTCT: ATTGATGTCT
GGGGTTTAGGA: GGGTTTAGGA
CAGCCTGCAAA: AGCCTGCAAA
CTTAAAAACAA: TTAAAAACAA
TTAGGCTAAGT: TAGGCTAAGT
CCAAATGGCAC: CAAATGGCAC
CCGGGGAAGAA: CGGGGAAGAA
CGACAGCCTGC: GACAGCCTGC
CCCAGGCGGAT: CCAGGCGGAT
ACCATAACAAC: CCATAACAAC
CCAAACATACT: CAAACATACT
GCAAAATACTA: CAAAATACTA
GATTTTACCCC: ATTTTACCCC
GCACGAACTTC: CACGAACTTC
AGGCGGATCGC: GGCGGATCGC
TCAAGGCACCG: CAAGGCACCG
GGGCTACTGCC: GGCTACTGCC
GGGCATGGAAC: GGCATGGAAC
GCGGCCTGTGA: CGGCCTGTGA
TTCTGCTTGGT: TCTGCTTGGT
TTGATCACCCC: TGATCACCCC
GCCTCGATCTC: CCTCGATCTC
CCGACAAGCCC: CGACAAGCCC CGACAAGCCC
GGTCTTGTTCG: GTCTTGTTCG
TGCCACTCCAA: GCCACTCCAA
CCGCCCGACAG: CGCCCGACAG
CCGATCACAAA: CGATCACAAA
TTCCCGGAGTG: TCCCGGAGTG
CTATTATAACC: TATTATAACC
AGGTCTCGATA: GGTCTCGATA
AACGCATCATA: ACGCATCATA
CTGTCACCCCC: TGTCACCCCC
GACCCGGCGGC: ACCCGGCGGC
AGCTCAGGTTA: GCTCAGGTTA
GATGTCTGGGC: ATGTCTGGGC
AACTCGCTAAG: ACTCGCTAAG
AGTCGACCAGA: GTCGACCAGA
GCATGCCACCT: CATGCCACCT
CCCGAAGCTGC: CCGAAGCTGC
CGGCTGTGACG: GGCTGTGACG
AATCGCATTAC: ATCGCATTAC
ATCTGACGAAA: TCTGACGAAA
CTGGGACGAAC: TGGGACGAAC
GGACCTAATAT: GACCTAATAT
TTTTAGGTGAT: TTTAGGTGAT
GGCCAAATCTG: GCCAAATCTG
TACAGAGAGAC: ACAGAGAGAC
GCTGTGATTGA: CTGTGATTGA
AAATTTATGAT: AATTTATGAT
GAGGAAGTGAG: AGGAAGTGAG
CCCCCAGGGAG: CCCCAGGGAG
AGACCATCCAG: GACCATCCAG
ACATACTACTC: CATACTACTC
GATAACGTTGA: ATAACGTTGA
GTCCCAAGGTA: TCCCAAGGTA
ATACTCTCGAT: TACTCTCGAT
TCCCGAAGCTG: CCCGAAGCTG
CAGCTAGACAC: AGCTAGACAC
CTGCAGTAATC: TGCAGTAATC
CTACCGTGTAG: TACCGTGTAG
AAACTGAATCC: AACTGAATCC
TTCCTTTTGTA: TCCTTTTGTA
AGCTGACTGTA: GCTGACTGTA
TGTTTGACTCT: GTTTGACTCT
CAGTCGACCAG: AGTCGACCAG
CCCGGGTTACG: CCGGGTTACG
CTAGACACTCA: TAGACACTCA
CCAAGGTAGTT: CAAGGTAGTT
AGGGCTACTGC: GGGCTACTGC
GTTAGAGTGCC: TTAGAGTGCC
AACAACTCATT: ACAACTCATT
TGTAGCCATAA: GTAGCCATAA
TCTGTATGCCA: CTGTATGCCA
CACTTCTGCTT: ACTTCTGCTT
AGAGTATCGGG: GAGTATCGGG
TCCTGAGACAA: CCTGAGACAA
GTTTATGTAAG: TTTATGTAAG
TAAGCTTTGCC: AAGCTTTGCC
ATGTAGCCATA: TGTAGCCATA
AGCTTTGCCGC: GCTTTGCCGC
GACAGATCAAG: ACAGATCAAG
ACAACTCATTT: CAACTCATTT
TCGATGACCAA: CGATGACCAA
ACTCATTTTGG: CTCATTTTGG
TTCCGATCACA: TCCGATCACA
AAAACTCTCGG: AAACTCTCGG
GTCCGACAAGC: TCCGACAAGC
GAAGACCACAT: AAGACCACAT
CATTGTATGTG: ATTGTATGTG
CGAACGTCCGC: GAACGTCCGC
CGTGTAGGTGA: GTGTAGGTGA
CCCGGCGGCTT: CCGGCGGCTT
AGGTTTTATCT: GGTTTTATCT
GTGTTTGACTC: TGTTTGACTC
GTGGGTAGACC: TGGGTAGACC
TTACAGAGAGA: TACAGAGAGA
CCGGGTCTACG: CGGGTCTACG
TCATTTTGGAC: CATTTTGGAC
TAGAGTGCCGG: AGAGTGCCGG
GCACGTAGCTG: CACGTAGCTG
TACCGTGTAGG: ACCGTGTAGG
AGTTCCTTTTG: GTTCCTTTTG
GATCAAGAAAC: ATCAAGAAAC
CCGACAGCCTG: CGACAGCCTG
AGTCCGACAAG: GTCCGACAAG
TCGACCAGAAC: CGACCAGAAC
TAGGTGATTAT: AGGTGATTAT
ACGCCCGCAGC: CGCCCGCAGC
CAAGCCCCAAA: AAGCCCCAAA
AGAATGCCGGC: GAATGCCGGC
CTGCCCGTCCC: TGCCCGTCCC
CAGTTCGGGCG: AGTTCGGGCG
AACAGGTTCTG: ACAGGTTCTG
CACCCCACCTG: ACCCCACCTG
AATGGACAATG: ATGGACAATG
TGAGTGATATC: GAGTGATATC
AGGATGGGGGC: GGATGGGGGC
CGGGCCCATGG: GGGCCCATGG
CTACAATCATG: TACAATCATG
TGTAATCTGAC: GTAATCTGAC
GGAGGTCGATC: GAGGTCGATC
GGTCATTGATC: GTCATTGATC
TTACCCCGGGT: TACCCCGGGT
AGGCTCAAGGT: GGCTCAAGGT
TGTATGTGCTT: GTATGTGCTT
GGGTAGACCAC: GGTAGACCAC
TCCAATAGTTA: CCAATAGTTA
ACCTGGACCTT: CCTGGACCTT
CGCATCATACA: GCATCATACA
CTTATTGACGG: TTATTGACGG
ACTCTGAATCT: CTCTGAATCT
CTTCATGCTTG: TTCATGCTTG
GTTTGGTTGTT: TTTGGTTGTT
CACCCCCAGGG: ACCCCCAGGG
AAGGTTTTATC: AGGTTTTATC
CTTCCCTCGCC: TTCCCTCGCC
ATGCCGGCTGT: TGCCGGCTGT
TAGGTGAGTTC: AGGTGAGTTC
ACCGTGTAGGT: CCGTGTAGGT
GCCAAATGGCA: CCAAATGGCA
GGCTGTGACGA: GCTGTGACGA
TTGACGTACAT: TGACGTACAT
AGCTATTATAA: GCTATTATAA
GTAAAGTGCCT: TAAAGTGCCT
CAAATCTGACG: AAATCTGACG
AGTGAGAGAGA: GTGAGAGAGA
GTGCTTCTCCC: TGCTTCTCCC
GTATGCCATCT: TATGCCATCT
TGATCATCGTA: GATCATCGTA
ACGTCCGCGCG: CGTCCGCGCG
CGAACTTCCCT: GAACTTCCCT
CGCCAGGTCTG: GCCAGGTCTG
ATAACCAAACA: TAACCAAACA
ACTACAACAGC: CTACAACAGC
GTAAGGCCCAG: TAAGGCCCAG
GAAGTGAGAGA: AAGTGAGAGA
GAGGGGTTGAT: AGGGGTTGAT
AATCCGGCACC: ATCCGGCACC
GGGGCACGGAC: GGGCACGGAC
AACCTGGACCT: ACCTGGACCT
CCATCTTAAAA: CATCTTAAAA
CTGGGCATGGA: TGGGCATGGA
GGGGCTTAGTC: GGGCTTAGTC
CCGCTCTCGTA: CGCTCTCGTA
CCTTGGACCTC: CTTGGACCTC
ACTCGGGACGA: CTCGGGACGA
GGATCGCGGCC: GATCGCGGCC
TGGTCGATTTA: GGTCGATTTA
CGTACATTGTA: GTACATTGTA
TTTTAGGCTAA: TTTAGGCTAA
AATATTTCCGA: ATATTTCCGA
GTAAGCTTTGC: TAAGCTTTGC
GAACAGGAAGA: AACAGGAAGA
AGTTTATCCTT: GTTTATCCTT
TTGACACCTTC: TGACACCTTC
ACCCCAGAGGG: CCCCAGAGGG
GCACGGACAGA: CACGGACAGA
CAGGTTCCTTA: AGGTTCCTTA
TTTAGCGATCG: TTAGCGATCG
GAGTGCCGGTC: AGTGCCGGTC
ACGTGTAGGAT: CGTGTAGGAT CGTGTAGGAT
TCGCTAAGAAT: CGCTAAGAAT
GTAGAGCTACA: TAGAGCTACA
CTGTGAGGTAG: TGTGAGGTAG
AGTGGGAATTT: GTGGGAATTT
GTCAAAGGGGC: TCAAAGGGGC
GAGACTAGCCC: AGACTAGCCC
ACTCGTAACGC: CTCGTAACGC
ATCATACAGGG: TCATACAGGG
CCCAAGGTAGT: CCAAGGTAGT
CCTTTCCCGGA: CTTTCCCGGA
AACCGACAAGC: ACCGACAAGC
AGGGGCGCTTT: GGGGCGCTTT
TCTTCATGCTT: CTTCATGCTT
GACTCTGAATC: ACTCTGAATC
TAAGGCCCAGC: AAGGCCCAGC
CTTAATACCCA: TTAATACCCA
AGCTATGCACC: GCTATGCACC
TTCACTGCCCG: TCACTGCCCG
CCTCGATCTCT: CTCGATCTCT
GGGACGAGGAC: GGACGAGGAC
TAATCTGTCAC: AATCTGTCAC
GCTTCTCCCAA: CTTCTCCCAA
CCATTGATCAT: CATTGATCAT
GCCGTGTTTGA: CCGTGTTTGA
TTTGTAATCTG: TTGTAATCTG
GCAGAGGGACT: CAGAGGGACT
CGACTGGAATG: GACTGGAATG
GCAGCGAGCTG: CAGCGAGCTG
ATCTGCAGTAA: TCTGCAGTAA
GAATCTACCGA: AATCTACCGA
GGCGCTTTTTA: GCGCTTTTTA
TGGGAATTTTA: GGGAATTTTA
CTGGTCGATTT: TGGTCGATTT
CCAAACTCGGG: CAAACTCGGG
GTGATATCTGC: TGATATCTGC
CTACCGACGAC: TACCGACGAC
AAGGTGGGTAG: AGGTGGGTAG
TAGTCCGACAA: AGTCCGACAA
GTTGATAACGT: TTGATAACGT
CCCAGCGTGGC: CCAGCGTGGC
GAGTGATATCT: AGTGATATCT
CATTTTGGACT: ATTTTGGACT
TTTTAGGGGGC: TTTAGGGGGC
CCCGGGCCCAT: CCGGGCCCAT
GTATCTGACGT: TATCTGACGT
CATAACAACTC: ATAACAACTC
ACTATTGACAG: CTATTGACAG
TCGACCTAGAC: CGACCTAGAC
CTTCTCCCAAA: TTCTCCCAAA
CAACGCCCGCA: AACGCCCGCA
TGATCACCCCA: GATCACCCCA
GGTTCTGCGCT: GTTCTGCGCT
TCCTGCGCCTC: CCTGCGCCTC
GACGAACCAGC: ACGAACCAGC
AGCCCCAAAAC: GCCCCAAAAC
TAGCGATCGTT: AGCGATCGTT
TCATAATGAAA: CATAATGAAA
TAATGAAATTT: AATGAAATTT
TGGACGGGGAA: GGACGGGGAA
TCTTAAAAACA: CTTAAAAACA
CCCATGGCCCA: CCATGGCCCA
TCATCGTAGTC: CATCGTAGTC
ATAACCTGGAC: TAACCTGGAC
GGCACCCTCGG: GCACCCTCGG
GGCCTGTGAGG: GCCTGTGAGG
CTCCGCCCGTT: TCCGCCCGTT
AGAGACTAGCC: GAGACTAGCC
GCTCAAGGTTT: CTCAAGGTTT
TTTTCGACTGG: TTTCGACTGG
GGGGCGCTTTT: GGGCGCTTTT
AGAGCTACAAT: GAGCTACAAT
CCCCAAAACTC: CCCAAAACTC
GCTCAGGTTAG: CTCAGGTTAG
CCATAACAGGT: CATAACAGGT
CGGTCGAGACA: GGTCGAGACA
TATTAGTGACA: ATTAGTGACA
AAAGAATCCTT: AAGAATCCTT
GTTACCATAAC: TTACCATAAC
TGACCCCGGGC: GACCCCGGGC
GGGGGCACGGA: GGGGCACGGA
TAACGCGCCGT: AACGCGCCGT
ACCGCACTAGC: CCGCACTAGC
GAAATTTATGA: AAATTTATGA
GAACGGCCGTC: AACGGCCGTC
AGTTAGTTACC: GTTAGTTACC
TTACCATAACA: TACCATAACA
ACCAAAACTGA: CCAAAACTGA
CGGATGGCACG: GGATGGCACG
GCATGGAACGG: CATGGAACGG
AATGCCGGCTG: ATGCCGGCTG
GCACGGGGTCT: CACGGGGTCT
ATGCTTGACAC: TGCTTGACAC
GTTGAATGGTG: TTGAATGGTG
TCGTCCTGAGA: CGTCCTGAGA
CAGCTAGAGCA: AGCTAGAGCA
AAGACTATTGA: AGACTATTGA
AGTGCCTGCGT: GTGCCTGCGT
AGTCGTCCTGA: GTCGTCCTGA
CCCCGGGCCCA: CCCGGGCCCA
CTGCAAATGGA: TGCAAATGGA
GCTCGGTCGAG: CTCGGTCGAG
AGTGCAGCTGT: GTGCAGCTGT
GGAGTGACGAG: GAGTGACGAG
TCTGCGCTATC: CTGCGCTATC
ATCTACCGACG: TCTACCGACG
TAGTTACCATA: AGTTACCATA
TACCATAACAA: ACCATAACAA
ATCGGATTCTC: TCGGATTCTC
TGATGTCTGGG: GATGTCTGGG
GAGGTCGATCA: AGGTCGATCA
GCACCGCCTTG: CACCGCCTTG
TCGTTCCAAAC: CGTTCCAAAC
TGGAACGGCCG: GGAACGGCCG
TAGGAGTTTGG: AGGAGTTTGG
TAACCTGGACC: AACCTGGACC
ATAGAGAACAG: TAGAGAACAG
AGGCACCGGGT: GGCACCGGGT
GGCATGGAACG: GCATGGAACG
ACAATGCTCAA: CAATGCTCAA
CACTCAGGCTC: ACTCAGGCTC
ACAAGCAGATA: CAAGCAGATA
CCGCGCCCCTC: CGCGCCCCTC
GTTAGACACGA: TTAGACACGA
AGCTTGAGTGA: GCTTGAGTGA
GAGGTAGAGCT: AGGTAGAGCT
TTCTCCCAAAC: TCTCCCAAAC
TGTAGGTGAGT: GTAGGTGAGT
TGCTTGGTTGA: GCTTGGTTGA
TAGCACGTAGC: AGCACGTAGC
AAACTCGCTAA: AACTCGCTAA
AAACTCGGGAC: AACTCGGGAC
TTTGACTCTGA: TTGACTCTGA
TCACCCCCAGG: CACCCCCAGG
GACGAAACAGG: ACGAAACAGG
GTAATCTGACC: TAATCTGACC
TTAGTCCGACA: TAGTCCGACA
AGACCCACTTC: GACCCACTTC
GCTTGAGTGAT: CTTGAGTGAT
CTCTTCATGCT: TCTTCATGCT
GCCCTTTTAGG: CCCTTTTAGG
GTGAGGTAGAG: TGAGGTAGAG
AGGTACACCGG: GGTACACCGG
ACAGGGTCCTG: CAGGGTCCTG
TCGGATTCTCC: CGGATTCTCC
AGACTACCGTG: GACTACCGTG
TAGACCCGTTG: AGACCCGTTG
CCCAAAACTCT: CCAAAACTCT
ACGTTGAATAA: CGTTGAATAA
CTTGGTTGAAT: TTGGTTGAAT
GCAGCTAGAGC: CAGCTAGAGC
GTCCAGTCGAC: TCCAGTCGAC
ATGGCACGGGG: TGGCACGGGG
GTTCATGGCAG: TTCATGGCAG
GGACTGGTCGA: GACTGGTCGA
CCTGCAAATGG: CTGCAAATGG
TTTAGGCTAAG: TTAGGCTAAG
GCCCCAAAACT: CCCCAAAACT
AGCAAAATACT: GCAAAATACT
TAGGATCGGAT: AGGATCGGAT
TTTCGAATCGC: TTCGAATCGC
TCGGCGGGCCA: CGGCGGGCCA
CTTCATGAAAT: TTCATGAAAT
TTTAGGTGATT: TTAGGTGATT
GTTAGTTACCA: TTAGTTACCA
GCCAGTGCCAC: CCAGTGCCAC
GGGGAAATAGC: GGGAAATAGC
GCATTACAGAG: CATTACAGAG
GGCGGATCGCG: GCGGATCGCG
CGTCCGCCGCT: GTCCGCCGCT
GCCTGCGTTCA: CCTGCGTTCA
CCAGGGAGGTC: CAGGGAGGTC
TACAGGGACCA: ACAGGGACCA
CCCAACCTTCA: CCAACCTTCA
TCCGCCGCTCT: CCGCCGCTCT
TATTTCCGATC: ATTTCCGATC
TGAGAGAGAAT: GAGAGAGAAT
TTCATGCTTGA: TCATGCTTGA
CACTGAGGTCT: ACTGAGGTCT
GGCAGCTAGAG: GCAGCTAGAG
AGGATCACTGA: GGATCACTGA
TAGCTCAGGTT: AGCTCAGGTT
CCCACTAGTCC: CCACTAGTCC
TAGCTGACTGT: AGCTGACTGT
TCCGACAAGCC: CCGACAAGCC
TCGACTGGAAT: CGACTGGAAT
GCACTAGCCCT: CACTAGCCCT
GTGCAGTCGTC: TGCAGTCGTC
TCTGACGAAAC: CTGACGAAAC
TATGGAGCTTG: ATGGAGCTTG
GGGGTTGATAA: GGGTTGATAA
TTAGCGATCGT: TAGCGATCGT
GAATAACCAAA: AATAACCAAA
ATAACAGGTTC: TAACAGGTTC
CCCTTTTAGGT: CCTTTTAGGT
CGGATACTCTC: GGATACTCTC
GGACTTAGAAT: GACTTAGAAT
AGGATCGGATT: GGATCGGATT
GAGAGAATTTT: AGAGAATTTT
TATAGACGGTA: ATAGACGGTA
GACAGCCTGCA: ACAGCCTGCA
AACCCCAGAGG: ACCCCAGAGG
CAATGCTCAAG: AATGCTCAAG
AACTCAAGTGG: ACTCAAGTGG
AATTTTAGGGG: ATTTTAGGGG
GCTAAGAATGC: CTAAGAATGC
AGGTGGGTAGA: GGTGGGTAGA
AGGAGTTTGGT: GGAGTTTGGT
AATGCTCAAGG: ATGCTCAAGG
TCTCCTGTAGA: CTCCTGTAGA
TAGACGGTAAA: AGACGGTAAA
CTGTAGAACCA: TGTAGAACCA
TACTACAACAG: ACTACAACAG
ACCTCCGTTCA: CCTCCGTTCA
GGAAGACCACA: GAAGACCACA
GGACCTCCGTT: GACCTCCGTT
AAATCTGACGA: AATCTGACGA
CAACCGACAAG: AACCGACAAG
GTCAGTTCGGG: TCAGTTCGGG
CTTTCCCGGAG: TTTCCCGGAG
TCTCTTCATGC: CTCTTCATGC
CGTCCGCGCGC: GTCCGCGCGC
AGCCCTTTTAG: GCCCTTTTAG
TTATGATGGAC: TATGATGGAC
GACTGGAATGA: ACTGGAATGA
GGATCACTGAG: GATCACTGAG
CCCGCAGCGAG: CCGCAGCGAG
AGGCCCAGCGT: GGCCCAGCGT
AGGTCTGTATG: GGTCTGTATG
ACCGCCCGACA: CCGCCCGACA
CCTCGGGGTTG: CTCGGGGTTG
GTTCTGCGCTA: TTCTGCGCTA
AATGGCACGAA: ATGGCACGAA
GGCTACTGCCA: GCTACTGCCA
CAGAGAGACTA: AGAGAGACTA
AATCATGTAGC: ATCATGTAGC
CGGTAAAGTGC: GGTAAAGTGC
GCTATCGGTCA: CTATCGGTCA
GTCTGGGCATG: TCTGGGCATG
TGACGTACATT: GACGTACATT
GCGAGCTGTGA: CGAGCTGTGA
CGGGTTACGTG: GGGTTACGTG
GTTGAATAATA: TTGAATAATA
GACAAGCCCCA: ACAAGCCCCA
AAATGTCCCAA: AATGTCCCAA
GCGAGTGGGAA: CGAGTGGGAA
GCGTTCACTGC: CGTTCACTGC
CGATAGAGAAC: GATAGAGAAC
CAGCGTGGCAT: AGCGTGGCAT
CGGGGAAGAAG: GGGGAAGAAG
GACCAAAACGT: ACCAAAACGT
CCGGGTTACGT: CGGGTTACGT
AACGGACTTAG: ACGGACTTAG
TGTCTGGGCAT: GTCTGGGCAT
ACTCCAGCTAG: CTCCAGCTAG
AGTTCAGCCTT: GTTCAGCCTT
GGTTAGAGTGC: GTTAGAGTGC
CGACCTAGACC: GACCTAGACC
ACGAAACAGGG: CGAAACAGGG
CCCGGAGTGAC: CCGGAGTGAC
GAATCCTTAGC: AATCCTTAGC
AAACAAGCAGA: AACAAGCAGA
CGTCCCGAAGC: GTCCCGAAGC
TGGACAATGCT: GGACAATGCT
CATACTACTCG: ATACTACTCG
GTCATAATGAA: TCATAATGAA
CTACGGGCCGC: TACGGGCCGC
GCGCCGTGTTT: CGCCGTGTTT
GGGTTGATAAC: GGTTGATAAC
CTCGGTCAGTT: TCGGTCAGTT
TCGGAGGGCTA: CGGAGGGCTA
TACTCTCGATG: ACTCTCGATG
ATCCGGCACCG: TCCGGCACCG
ACTTCTGCTTG: CTTCTGCTTG
GCTATTATAAC: CTATTATAAC
TGACGAAACAG: GACGAAACAG
TGCAGGGACCC: GCAGGGACCC
TCTGACCCCGG: CTGACCCCGG
TGCTTCTCCCA: GCTTCTCCCA
GTCACCCCCAG: TCACCCCCAG
GTCTCGATAGA: TCTCGATAGA
AGCTCGGTCGA: GCTCGGTCGA
TCTCGTAGGGG: CTCGTAGGGG
TGGTCGGTCGG: GGTCGGTCGG
CCGCGCGCCAG: CGCGCGCCAG
GGCGGCAGAGG: GCGGCAGAGG
GGTCGGAGGGC: GTCGGAGGGC
AAAGTGCCTGC: AAGTGCCTGC
GGCTAAGTTCA: GCTAAGTTCA
ACCTGCAGGGA: CCTGCAGGGA
CCCCGGGTTAC: CCCGGGTTAC
ACCCCGGGTTA: CCCCGGGTTA
TAGCCATAACA: AGCCATAACA
GGAACTCGAGT: GAACTCGAGT
TAATATTTCCG: AATATTTCCG
GTCGGTCGGAG: TCGGTCGGAG
ATTAGCACGTA: TTAGCACGTA
CCTTAGCTGAC: CTTAGCTGAC
ATCAAGAAACT: TCAAGAAACT
CACGGGGTCTT: ACGGGGTCTT
TACCCAGGCGG: ACCCAGGCGG
TATAACCTGGA: ATAACCTGGA
GACTGGTCGAT: ACTGGTCGAT
AAACTCAAGTG: AACTCAAGTG
CTCAAGGTTTT: TCAAGGTTTT
CATAATCTCCT: ATAATCTCCT
ATATTTCCGAT: TATTTCCGAT
CTCTCGTAGGG: TCTCGTAGGG
TGACACCTTCA: GACACCTTCA
CCTCGGAAGAC: CTCGGAAGAC
ATTTCCGATCA: TTTCCGATCA
CAGACGGTCAA: AGACGGTCAA
ATGAGAAGACT: TGAGAAGACT
CTCCAATAGTT: TCCAATAGTT
AACTCGAGTTT: ACTCGAGTTT
AAGGGGTTTAG: AGGGGTTTAG
GACCCGTTGAC: ACCCGTTGAC
AAATATGGAGC: AATATGGAGC
CCTTTTAGGTG: CTTTTAGGTG
AATTAATCTGT: ATTAATCTGT
GGGCCGCGCCC: GGCCGCGCCC
CTAAGAATGCC: TAAGAATGCC
ATCGGTGTATC: TCGGTGTATC
AGTTCGGGCGG: GTTCGGGCGG
GTCTTGCAGGG: TCTTGCAGGG
TCCGGCACCGC: CCGGCACCGC
GGAATGAGAAG: GAATGAGAAG
ATGGGGGCAGA: TGGGGGCAGA
CATTGATCATC: ATTGATCATC
ACCTTATTGAC: CCTTATTGAC
ATAGCAAGGTA: TAGCAAGGTA
CGGCGGGCCAA: GGCGGGCCAA
AATACTACAAC: ATACTACAAC
TATGTAAGAAG: ATGTAAGAAG
CTCGATCTCTT: TCGATCTCTT
CTTGTTCGGAT: TTGTTCGGAT
GCCATAACAGG: CCATAACAGG
GCCATCTTAAA: CCATCTTAAA
GAATGCCGGCT: AATGCCGGCT
GGTAAGCTTTG: GTAAGCTTTG
GCCGTCCGCCG: CCGTCCGCCG
CTGTAACGCGC: TGTAACGCGC
CCGGTAGATCT: CGGTAGATCT
TGCCCGTCCCG: GCCCGTCCCG
TTCGAATCGCA: TCGAATCGCA
GAGTGACGAGT: AGTGACGAGT
GAGACAACGCC: AGACAACGCC
GTCGAACGTCC: TCGAACGTCC
GCCCAACCTTC: CCCAACCTTC
TGGCACGGGGT: GGCACGGGGT
TTAAAAACAAT: TAAAAACAAT
CTCAGGTTAGA: TCAGGTTAGA
GCAGACGGTCA: CAGACGGTCA
ACAGGGACCAA: CAGGGACCAA
CTAGCCCTTGT: TAGCCCTTGT
CAACAGCTCGG: AACAGCTCGG
GGCACGGGGTC: GCACGGGGTC
CACATTAGCAC: ACATTAGCAC
AGACTAGCCCT: GACTAGCCCT
TGACTCTGAAT: GACTCTGAAT
TGGAATGAGAA: GGAATGAGAA
TGACAGGTTCC: GACAGGTTCC
GCTTTGCCGCA: CTTTGCCGCA
CGTCGAACGTC: GTCGAACGTC
CCTGTGAGGTA: CTGTGAGGTA
TAGGGGCACCC: AGGGGCACCC
CCCTTGTTAGA: CCTTGTTAGA
ACCAAAATGGT: CCAAAATGGT
CTTTGCCGCAG: TTTGCCGCAG
CAAGGTAGTTT: AAGGTAGTTT
CCTTAATACCC: CTTAATACCC
AGGTCGATCAT: GGTCGATCAT
CCAGGTCTGTA: CAGGTCTGTA
CTCGGCGGGCC: TCGGCGGGCC
AGAAGGGGTTT: GAAGGGGTTT
TAGACACTCAG: AGACACTCAG
ATTGACGGAGT: TTGACGGAGT
CAAAACTGAAT: AAAACTGAAT
AGTATCGGGCT: GTATCGGGCT
GACCTTTCCCG: ACCTTTCCCG
GGCAGAGGGAC: GCAGAGGGAC
ATTTTACCCCG: TTTTACCCCG
CAGGTTCTGCG: AGGTTCTGCG
AAACATACTAC: AACATACTAC
TCTACCGACGA: CTACCGACGA
TGCCATAATCT: GCCATAATCT
TGTAGAACCAA: GTAGAACCAA
GGAAGTGAGAG: GAAGTGAGAG
CCCCAGGGAGG: CCCAGGGAGG
GCTTTTCGAAT: CTTTTCGAAT
TCCGCGCGCCA: CCGCGCGCCA
ACCCCACCTGC: CCCCACCTGC
GCTCAAGGCAC: CTCAAGGCAC
CTCGAGGAAGT: TCGAGGAAGT
ACCGACAAGCC: CCGACAAGCC
GCAGACCCACT: CAGACCCACT
TTTCCCGGAGT: TTCCCGGAGT
CGTCCTGAGAC: GTCCTGAGAC
GACGACCTGTC: ACGACCTGTC
GGATTCTCCGC: GATTCTCCGC
CTAGCCCTTTT: TAGCCCTTTT
TGCGCCTCGAT: GCGCCTCGAT
CCAAAATGGTC: CAAAATGGTC
GAAATAGCAAG: AAATAGCAAG
CGGGGTTGACG: GGGGTTGACG
TATCTCGAGGA: ATCTCGAGGA
CTCGGGACGAG: TCGGGACGAG
TCATGTAGCCA: CATGTAGCCA
GACCACATTAG: ACCACATTAG
GAGAAGGGGTT: AGAAGGGGTT
AGAGGGGTTGA: GAGGGGTTGA
AATTTTCGACT: ATTTTCGACT
ATCCGCCAAAT: TCCGCCAAAT
GTTTAGCGATC: TTTAGCGATC
CGAGGACCTAA: GAGGACCTAA
CCAGCGAGTGG: CAGCGAGTGG
ACCGACGACCT: CCGACGACCT
ATCGCATTACA: TCGCATTACA
AGAAGCTATTA: GAAGCTATTA
TTATTTAAAAT: TATTTAAAAT
TCTTGCAGGGA: CTTGCAGGGA
ACGACCTGTCC: CGACCTGTCC
ACCAAACAAGC: CCAAACAAGC
CGAAGCTGCAG: GAAGCTGCAG
TCCTGGGACGA: CCTGGGACGA
CGGGCGGCAGA: GGGCGGCAGA
CCTCATACCGC: CTCATACCGC
CGATTGCCGGT: GATTGCCGGT
TTTTGTAATCT: TTTGTAATCT
GAATCGCATTA: AATCGCATTA
CGTCTTGCAGG: GTCTTGCAGG
AGAACCCCAGA: GAACCCCAGA
ACCCGTTGACA: CCCGTTGACA
GGTAGAGCTAC: GTAGAGCTAC
GGGAAGAAGGT: GGAAGAAGGT
GAACCCCAGAG: AACCCCAGAG
CAGTGCCACTC: AGTGCCACTC
TCCGTTCATGG: CCGTTCATGG
ACGGGCCGCGC: CGGGCCGCGC
GTGACGAGTGC: TGACGAGTGC
GTTCCTTTTGT: TTCCTTTTGT
GGCCCACTAGT: GCCCACTAGT
ATGCCATCTTA: TGCCATCTTA
TAATACCCAGG: AATACCCAGG
AAACAATTAAT: AACAATTAAT
TGATTGATGTC: GATTGATGTC
TGCAAATGGAC: GCAAATGGAC
GCACCGGGTCT: CACCGGGTCT
TAGAACCAAAA: AGAACCAAAA
TCCAAACTCGG: CCAAACTCGG
CCGCAGAAGCT: CGCAGAAGCT
CTGCAGACCCA: TGCAGACCCA
CGGGCCGCGCC: GGGCCGCGCC
GCCGCGCCCCT: CCGCGCCCCT
TAGCTATGCAC: AGCTATGCAC
ACGAACTTCCC: CGAACTTCCC
GATTCCATTGA: ATTCCATTGA
CGTTGAATAAT: GTTGAATAAT
CGAAACAGGGT: GAAACAGGGT
TAGCCCTTGTT: AGCCCTTGTT
TAGACCACCCG: AGACCACCCG
AAGTGGTCGAC: AGTGGTCGAC
CATGGAACGGC: ATGGAACGGC
ATTTTAGGGGG: TTTTAGGGGG
TGCCGGCTGTG: GCCGGCTGTG
TAATACGATAT: AATACGATAT
TTTAGGGCAGC: TTAGGGCAGC
TTGATCATCGT: TGATCATCGT
ACCTAGACCCG: CCTAGACCCG
GTAGGTGAGTT: TAGGTGAGTT
CCGGCGGCTTA: CGGCGGCTTA
AATCTCCTGTA: ATCTCCTGTA
CTTCTGCTTGG: TTCTGCTTGG
AGTGATATCTG: GTGATATCTG
CCAAAACTGAA: CAAAACTGAA
TGCTTGACACC: GCTTGACACC
CACCGGGGAAG: ACCGGGGAAG
TTGCCGGTAAG: TGCCGGTAAG
GGGATTTTACC: GGATTTTACC
CAAGCAGATAG: AAGCAGATAG
TATCTGACGTC: ATCTGACGTC
TCCTTAATACC: CCTTAATACC
CAGGGATTTTA: AGGGATTTTA
CCATAATCTCC: CATAATCTCC
TGACGAGAAGG: GACGAGAAGG
TGTAGGATGGG: GTAGGATGGG
GCCAGGTCTGT: CCAGGTCTGT
AGTCGCGGATG: GTCGCGGATG
AACATACTACT: ACATACTACT
AGCCCAACCTT: GCCCAACCTT
TCGATAGAGAA: CGATAGAGAA
GCCTGTGAGGT: CCTGTGAGGT
GAACGTCCGCG: AACGTCCGCG
TGGCACGAACT: GGCACGAACT
GCAGGGACCCG: CAGGGACCCG
CCGCAGCGAGC: CGCAGCGAGC
GGGCACCCTCG: GGCACCCTCG
GAAGGTGGGTA: AAGGTGGGTA
ACAGATCAAGA: CAGATCAAGA
TTACGTGTAGG: TACGTGTAGG
CGCTTTTCGAA: GCTTTTCGAA
CCCCTCGGAAG: CCCTCGGAAG
GCGCCAGTGCC: CGCCAGTGCC
CTGACGTCCAG: TGACGTCCAG
TCAAGGTTTTA: CAAGGTTTTA
CCGGGCCCATG: CGGGCCCATG
TCTCGGTCAGT: CTCGGTCAGT
GGGCGCTTTTT: GGCGCTTTTT
CGCGCGCCAGT: GCGCGCCAGT
AGGTGATTATT: GGTGATTATT
GGTTGAATGGT: GTTGAATGGT
GGCACCGGGTC: GCACCGGGTC
GTTCACTGCCC: TTCACTGCCC
CCCGTTCGATT: CCGTTCGATT
GTCGTCCTGAG: TCGTCCTGAG
CCAGCGTGGCA: CAGCGTGGCA
TTTGGACTCCA: TTGGACTCCA
GTCGACCTAGA: TCGACCTAGA
GAAGATTAACG: AAGATTAACG
GCCACTCCAAT: CCACTCCAAT
AGATAGCTATG: GATAGCTATG
GCGGATGGCAC: CGGATGGCAC
GTGTGCGCCAG: TGTGCGCCAG
GTAGCTGGAAC: TAGCTGGAAC
ACATTGTATGT: CATTGTATGT
AGGGATTTTAC: GGGATTTTAC
TGACCAAAACG: GACCAAAACG
CGTCCAGTCGA: GTCCAGTCGA
CCTGCGCCTCG: CTGCGCCTCG
GACGAGTGCAG: ACGAGTGCAG
AGGGACCAAAA: GGGACCAAAA
CTAGAGCAACC: TAGAGCAACC
CGCGCCAGTGC: GCGCCAGTGC
CTGAATCTACC: TGAATCTACC
TTGTATGTGCT: TGTATGTGCT
TACTCGTAACG: ACTCGTAACG
TCGCCCAGCGA: CGCCCAGCGA
ACTCGAGTTTA: CTCGAGTTTA
AGATTAACGGA: GATTAACGGA
ATACTACTCGT: TACTACTCGT
AGGGGTTTAGG: GGGGTTTAGG
GATGACCAAAA: ATGACCAAAA
CCTTATTGACG: CTTATTGACG
ATGACCAAAAC: TGACCAAAAC
ATGATGGACGG: TGATGGACGG
GTACACCGGGG: TACACCGGGG
CAGTAATCCGG: AGTAATCCGG
CCGTTCATGGC: CGTTCATGGC
GTAGCCATAAC: TAGCCATAAC
CATAACAGGTT: ATAACAGGTT
GCGCCCCTCGG: CGCCCCTCGG
ATTAATCTGTC: TTAATCTGTC
CTTTTCGAATC: TTTTCGAATC
AGCACGTAGCT: GCACGTAGCT
GAGTGGGAATT: AGTGGGAATT
TCTGTCACCCC: CTGTCACCCC
CTGACTGTAAC: TGACTGTAAC
CAAGGTACACC: AAGGTACACC
ACTAGCCCTTG: CTAGCCCTTG
CACGTAGCTGG: ACGTAGCTGG
GTTCAGCCTTC: TTCAGCCTTC
CTCATTTTGGA: TCATTTTGGA
TACAACAGCTC: ACAACAGCTC
ATCGGTCATTG: TCGGTCATTG
GTGTATCTGAC: TGTATCTGAC
ACACCTTCATG: CACCTTCATG
ACTGGAATGAG: CTGGAATGAG
TGCTCAAGGCA: GCTCAAGGCA
CTCGATAGAGA: TCGATAGAGA
CAGCGAGCTGT: AGCGAGCTGT
CGGTGTATCTG: GGTGTATCTG
CTTAGTGTAAG: TTAGTGTAAG
ACGCATCATAC: CGCATCATAC
ACGGGGTCTTG: CGGGGTCTTG
GGACGGGGAAA: GACGGGGAAA
AACTTCCCTCG: ACTTCCCTCG
CCGTCGAACGT: CGTCGAACGT
CCACTCCAATA: CACTCCAATA
GGGACTGGTCG: GGACTGGTCG
CCTAGACCCGT: CTAGACCCGT
GGCCCATGGCC: GCCCATGGCC
GGACTCCAGCT: GACTCCAGCT
AACAGGGTCCT: ACAGGGTCCT
GAATGGTGTGC: AATGGTGTGC
CAAAATACTAC: AAAATACTAC
TTAGCACGTAG: TAGCACGTAG
GATTATTAGTG: ATTATTAGTG
GCCGGCTGTGA: CCGGCTGTGA
AATGAAATTTA: ATGAAATTTA
ACTCAGGCTCA: CTCAGGCTCA
AACCAAAACTG: ACCAAAACTG
CTATTGACAGT: TATTGACAGT
GCGGATCGCGG: CGGATCGCGG
ATGTCTGGGCA: TGTCTGGGCA
TGCAGTAATCC: GCAGTAATCC
ACTTAGAATAA: CTTAGAATAA
ATCCAGAGTAT: TCCAGAGTAT
GATGGGGGCAG: ATGGGGGCAG
AGAATCCTTAG: GAATCCTTAG
CTGCGCTATCG: TGCGCTATCG
TATCGGGCTCC: ATCGGGCTCC
ATTGATCATCG: TTGATCATCG
TTCCCTCGCCC: TCCCTCGCCC
ACATTAGCACG: CATTAGCACG
ACTACCGTGTA: CTACCGTGTA
TCGATTTAGGG: CGATTTAGGG
GTAACGCGCCG: TAACGCGCCG
TGGCAGCTAGA: GGCAGCTAGA
TGCAGACCCAC: GCAGACCCAC
ACAGTGCAGCT: CAGTGCAGCT
TACATTGTATG: ACATTGTATG
GGTCGATTTAG: GTCGATTTAG
TCGGTGTATCT: CGGTGTATCT
CCTAATATTTC: CTAATATTTC
GACCTCCGTTC: ACCTCCGTTC
CTACTGCCATA: TACTGCCATA
TCGGGACGAGG: CGGGACGAGG
TTATTAGTGAC: TATTAGTGAC
TGACGAGTGCA: GACGAGTGCA
CCATAACAACT: CATAACAACT
TATTGACAGTG: ATTGACAGTG
GAGCAACCGAC: AGCAACCGAC
GATGGACGGGG: ATGGACGGGG
ACCTTTCCCGG: CCTTTCCCGG
ATGCCACCTTA: TGCCACCTTA
CCGCCAAATGG: CGCCAAATGG
GCAACCGACAA: CAACCGACAA
CTATCGGTCAT: TATCGGTCAT
CTGTGATTGAT: TGTGATTGAT
CAGTGCAGCTG: AGTGCAGCTG
GTCTGTATGCC: TCTGTATGCC
AGGGGGCACGG: GGGGGCACGG
GCACCCTCGGG: CACCCTCGGG
TAGATCTCCGT: AGATCTCCGT
GTAGTCTCGGC: TAGTCTCGGC
TGTAACGCGCC: GTAACGCGCC
AGCTGGAACTC: GCTGGAACTC
TGACAGTGCAG: GACAGTGCAG
CAAGGTTTTAT: AAGGTTTTAT
TCGGTCGGAGG: CGGTCGGAGG
CCCACCTGCAG: CCACCTGCAG
CCGTCCCGAAG: CGTCCCGAAG
AGACCACATTA: GACCACATTA
GACGGTCAAAG: ACGGTCAAAG
TGTGCTTCTCC: GTGCTTCTCC
CGAGCTGTGAT: GAGCTGTGAT
TGGGCATGGAA: GGGCATGGAA
GTAGTTTATCC: TAGTTTATCC
CGATCGTTCCA: GATCGTTCCA
ACTACTCGTAA: CTACTCGTAA
AATATGGAGCT: ATATGGAGCT
CCGGTCCCTCA: CGGTCCCTCA
AAGGATCACTG: AGGATCACTG
GTGTAGGTGAG: TGTAGGTGAG
CGCGCCCCTCG: GCGCCCCTCG
GTCGGAGGGCT: TCGGAGGGCT
TGGCATGCCAC: GGCATGCCAC
TAGTCTCGGCG: AGTCTCGGCG
CTGACCCCGGG: TGACCCCGGG
GGGGTCTTGTT: GGGTCTTGTT
GATCGTTCCAA: ATCGTTCCAA
CCGCCGCTCTC: CGCCGCTCTC
AAGGTACACCG: AGGTACACCG
GTGCAGCTGTC: TGCAGCTGTC
CTCGGTCGAGA: TCGGTCGAGA
ACTCAAGTGGT: CTCAAGTGGT
CAGCTCGGTCG: AGCTCGGTCG
CCTGTAGAACC: CTGTAGAACC
CCTCGCCCAGC: CTCGCCCAGC
TTAGTGTAAGG: TAGTGTAAGG
ATGGACGGGGA: TGGACGGGGA
TGAATAATACG: GAATAATACG
TTTATCTCGAG: TTATCTCGAG
CGAATCGCATT: GAATCGCATT
GGTCGATCATC: GTCGATCATC
GAAGGGGTTTA: AAGGGGTTTA
CAAAGAATCCT: AAAGAATCCT
CTGCAGGGATT: TGCAGGGATT
ACAACGCCCGC: CAACGCCCGC
TCTCGATAGAG: CTCGATAGAG
GGTCTGTATGC: GTCTGTATGC
GATCACTGAGG: ATCACTGAGG
CGGATCGCGGC: GGATCGCGGC
CGCTAAGAATG: GCTAAGAATG
AGCAGATAGCT: GCAGATAGCT
ATAGCTATGCA: TAGCTATGCA
AAGAAACTCGC: AGAAACTCGC
TGGTTGTTTAG: GGTTGTTTAG
CTGGAATGAGA: TGGAATGAGA
GGTGTGCGCCA: GTGTGCGCCA
TTATCCTTAGT: TATCCTTAGT
GATCATCGTAG: ATCATCGTAG
GATCGCGGCCT: ATCGCGGCCT
GTCCGCCGCTC: TCCGCCGCTC
GAGTTTATGTA: AGTTTATGTA
TCAGGCTCAAG: CAGGCTCAAG
AGAGAACAGGA: GAGAACAGGA
ACAGGAAGATT: CAGGAAGATT
GTACATTGTAT: TACATTGTAT
CGCCCAGCGAG: GCCCAGCGAG
TACACCGGGGA: ACACCGGGGA
ATTGACAGTGC: TTGACAGTGC
CCAGTCGACCA: CAGTCGACCA
CCAAACAAGCA: CAAACAAGCA
AGTTTGGTTGT: GTTTGGTTGT
GGCAGCGTCTT: GCAGCGTCTT
CGCCAGTGCCA: GCCAGTGCCA
CACCGCCCGAC: ACCGCCCGAC
AAACTCTCGGT: AACTCTCGGT
AGTGCCGGTCC: GTGCCGGTCC
TGATTATTAGT: GATTATTAGT
ACCTGTCCGCT: CCTGTCCGCT
CTCAGGCTCAA: TCAGGCTCAA
TCCCGGAGTGA: CCCGGAGTGA
GGTGATTATTA: GTGATTATTA
AAAATACTACA: AAATACTACA
TCGGTCAGTTC: CGGTCAGTTC
GTATGTGCTTC: TATGTGCTTC
GTTCCAAACTC: TTCCAAACTC
AACGCCCGCAG: ACGCCCGCAG
TTGTTTAGCGA: TGTTTAGCGA
TCATACAGGGA: CATACAGGGA
CTCCTGCGCCT: TCCTGCGCCT
GCTCCTGCGCC: CTCCTGCGCC
TTTATGTAAGA: TTATGTAAGA
GTTTGACTCTG: TTTGACTCTG
CCTTCAAACTC: CTTCAAACTC
TTCGATTGCCG: TCGATTGCCG
CAGAGTATCGG: AGAGTATCGG
ATGGAGCTTGA: TGGAGCTTGA
ACGGAGTCATA: CGGAGTCATA
TGGACCTTTCC: GGACCTTTCC
AGACCACCCGG: GACCACCCGG
TAGTCCGGATA: AGTCCGGATA
TTATCTCGAGG: TATCTCGAGG
TGTGATTGATG: GTGATTGATG
AGCGAGACCAT: GCGAGACCAT
ACCCCCAGGGA: CCCCCAGGGA
AGGTTCCTTAA: GGTTCCTTAA
AACAGGAAGAT: ACAGGAAGAT
GCAGAAGCTAT: CAGAAGCTAT
GGTTTAGGAGT: GTTTAGGAGT
AGCGATCGTTC: GCGATCGTTC
TAGGCTAAGTT: AGGCTAAGTT
GGATGGGGGCA: GATGGGGGCA
TCCGCCAAATG: CCGCCAAATG
AGTGACAGATC: GTGACAGATC
GATATCTGCAG: ATATCTGCAG
CATTAGCACGT: ATTAGCACGT
CGGCCTGTGAG: GGCCTGTGAG
TATGCACCGCC: ATGCACCGCC
AGCAAGGTACA: GCAAGGTACA
GGGTCCTGGGA: GGTCCTGGGA
ACCCACTTCTG: CCCACTTCTG
ACTTCCCTCGC: CTTCCCTCGC
CCAGGCGGATC: CAGGCGGATC
CAAATGGACAA: AAATGGACAA
GCAGTAATCCG: CAGTAATCCG
CTCCGTTCATG: TCCGTTCATG
GCAGTCGTCCT: CAGTCGTCCT
CTCGTAGGGGC: TCGTAGGGGC
GGTTGACGTAC: GTTGACGTAC
GGGCACGGACA: GGCACGGACA
CCGGATACTCT: CGGATACTCT
GATAGCTATGC: ATAGCTATGC
CGGTCAGTTCG: GGTCAGTTCG
TTGTTAGACAC: TGTTAGACAC
CGAGAGGGGTT: GAGAGGGGTT
ATGGTCGGTCG: TGGTCGGTCG
TATGCCATCTT: ATGCCATCTT
TAGAGCTACAA: AGAGCTACAA
CGTGTAGGATG: GTGTAGGATG
CAAACAAGCAG: AAACAAGCAG
GACCTAATATT: ACCTAATATT
AGGCTAAGTTC: GGCTAAGTTC
CCCAGAGGGGC: CCAGAGGGGC
GACTGTAACGC: ACTGTAACGC
TGACGTCCAGT: GACGTCCAGT
GAAACAGGGTC: AAACAGGGTC
ACAAAGAATCC: CAAAGAATCC
TGCGCCAGGTC: GCGCCAGGTC
ATATCTGCAGT: TATCTGCAGT
TTCTCCGCCCG: TCTCCGCCCG
TTAGTTACCAT: TAGTTACCAT
ACTGCCCGTCC: CTGCCCGTCC
GTGATTATTAG: TGATTATTAG
TTTTACCCCGG: TTTACCCCGG
GGAACGGCCGT: GAACGGCCGT
TGACGGAGTCA: GACGGAGTCA
ATTCTCCGCCC: TTCTCCGCCC
CTAAGTTCAGC: TAAGTTCAGC
ACGCGCCGTGT: CGCGCCGTGT
GACGTACATTG: ACGTACATTG
CTGCGCCTCGA: TGCGCCTCGA
CGGTAGATCTC: GGTAGATCTC
ATGGCACGAAC: TGGCACGAAC
AGTCATAATGA: GTCATAATGA
TTTAGGGGGCA: TTAGGGGGCA
GCATCATACAG: CATCATACAG
TGAGAAGACTA: GAGAAGACTA
TAGCTGGAACT: AGCTGGAACT
TCCTGTAGAAC: CCTGTAGAAC
AGGTGAGTTCC: GGTGAGTTCC
CCACCTTATTG: CACCTTATTG
TGTAAGAAGAG: GTAAGAAGAG
GTGATTGATGT: TGATTGATGT
ACGGTAAAGTG: CGGTAAAGTG
ACCCGGCGGCT: CCCGGCGGCT
TCGCGGCCTGT: CGCGGCCTGT
AGCGTCTTGCA: GCGTCTTGCA
TTATGTAAGAA: TATGTAAGAA
ACAGGTTCTGC: CAGGTTCTGC
ATCGTTCCAAA: TCGTTCCAAA
AGCCTTCCAGC: GCCTTCCAGC
TCGATTGCCGG: CGATTGCCGG
CGACGACCTGT: GACGACCTGT
AGTGCAGTCGT: GTGCAGTCGT
ACAAGCCCCAA: CAAGCCCCAA
GGGCGGCAGAG: GGCGGCAGAG
AAAAACAATTA: AAAACAATTA
GGTCGACCTAG: GTCGACCTAG
CCTGGACCTTT: CTGGACCTTT
GACAACGCCCG: ACAACGCCCG
CACCTGCAGGG: ACCTGCAGGG
CCAGCGAGACC: CAGCGAGACC
GCTGACTGTAA: CTGACTGTAA
TTGACAGTGCA: TGACAGTGCA
GGATTCCATTG: GATTCCATTG
GATCACAAAGA: ATCACAAAGA
ACTCTCGATGA: CTCTCGATGA
AAAATGGTCGG: AAATGGTCGG
ACGTCCAGTCG: CGTCCAGTCG
TAATCCGGCAC: AATCCGGCAC
TCTCGGCGGGC: CTCGGCGGGC
ACAAGCCCAAC: CAAGCCCAAC
CCTTCATGAAA: CTTCATGAAA
AACAGCTCGGT: ACAGCTCGGT
AGAGAGAATTT: GAGAGAATTT
GCTAGACACTC: CTAGACACTC
GACGTCCAGTC: ACGTCCAGTC
AAGAAGAGTCG: AGAAGAGTCG
AATCTGTCACC: ATCTGTCACC
CGAACCAGCAA: GAACCAGCAA
TCTCCCAAACA: CTCCCAAACA
GAGAGACTAGC: AGAGACTAGC
CGCGCCGTGTT: GCGCCGTGTT
GCTGTGACGAG: CTGTGACGAG
GACCACCCGGT: ACCACCCGGT
CCACCCGGTAG: CACCCGGTAG
CCCGGTAGATC: CCGGTAGATC
CTCCAGCTAGA: TCCAGCTAGA
TCGGAAGACCA: CGGAAGACCA
TCGTAACGCAT: CGTAACGCAT
CAAGGCACCGG: AAGGCACCGG
TGGTCGACCTA: GGTCGACCTA
GTCGACCAGAA: TCGACCAGAA
GTGGCATGCCA: TGGCATGCCA
ATCCTTAGTGT: TCCTTAGTGT
AAGATTAACGG: AGATTAACGG
AATCTACCGAC: ATCTACCGAC
GGTGTATCTGA: GTGTATCTGA
TCAGTTCGGGC: CAGTTCGGGC
GCTAAGTTCAG: CTAAGTTCAG
TCCATTGATCA: CCATTGATCA
CGGAGTCATAA: GGAGTCATAA
GTCTCGGCGGG: TCTCGGCGGG
GACACTCAGGC: ACACTCAGGC
TTGTTCGGATT: TGTTCGGATT
GGTTGATAACG: GTTGATAACG
ACCGGGGAAGA: CCGGGGAAGA
GGATGGCACGG: GATGGCACGG
GTTCGGGCGGC: TTCGGGCGGC
AGTCCGGATAC: GTCCGGATAC
GGTAGTTTATC: GTAGTTTATC
CCTTCCAGCGA: CTTCCAGCGA
GAGAAGACTAT: AGAAGACTAT
TAACGGACTTA: AACGGACTTA
TCCCAAGGTAG: CCCAAGGTAG
CGTGGCATGCC: GTGGCATGCC
CGCACTAGCCC: GCACTAGCCC
AGCCCTTGTTA: GCCCTTGTTA
GACACGAGAGG: ACACGAGAGG
ATTTTCGACTG: TTTTCGACTG
AAGCCCAACCT: AGCCCAACCT
GAGGTCTCGAT: AGGTCTCGAT
TGCAGGGATTT: GCAGGGATTT
ACGTAGCTGGA: CGTAGCTGGA
CAGAGGGACTG: AGAGGGACTG
CATTGATCACC: ATTGATCACC
GTCGATCATCT: TCGATCATCT
TAGGGCAGCGT: AGGGCAGCGT
GTCCGCTTTTC: TCCGCTTTTC
CATGGCAGCTA: ATGGCAGCTA
TTGACTCTGAA: TGACTCTGAA
AGAGGGACTGG: GAGGGACTGG
TAGTTAGTTAC: AGTTAGTTAC
TACAATCATGT: ACAATCATGT
CGACCAGAACC: GACCAGAACC
GACCCACTTCT: ACCCACTTCT
GTTTTATCTCG: TTTTATCTCG
GGGTTGACGTA: GGTTGACGTA
TTGTAATCTGA: TGTAATCTGA
CAGGAAGATTA: AGGAAGATTA
CCAGCTAGACA: CAGCTAGACA
AGCCTGCAAAT: GCCTGCAAAT
TCCAGCTAGAC: CCAGCTAGAC
GGAATTTTAGG: GAATTTTAGG
AGTGACGAGTG: GTGACGAGTG
TCGGGGTTGAC: CGGGGTTGAC
GGGCAGACGGT: GGCAGACGGT
GTGGTCGACCT: TGGTCGACCT
ATACTACAACA: TACTACAACA
GCGGCAGAGGG: CGGCAGAGGG
CGGAAGACCAC: GGAAGACCAC
CGGCAGAGGGA: GGCAGAGGGA
CCGGCTGTGAC: CGGCTGTGAC
CGCGGATGGCA: GCGGATGGCA
CAAATGGCACG: AAATGGCACG
GCAGATAGCTA: CAGATAGCTA
TAATCTCCTGT: AATCTCCTGT
CCTTTTGTAAT: CTTTTGTAAT
CTCGCCCAGCG: TCGCCCAGCG
GGCGGCTTAGC: GCGGCTTAGC
CTTGGACCTCC: TTGGACCTCC
ATCGCGGCCTG: TCGCGGCCTG
CGAGAAGGGGT: GAGAAGGGGT
GAAGAAGGTGG: AAGAAGGTGG
GCCGGTAAGCT: CCGGTAAGCT
CCCTCGGAAGA: CCTCGGAAGA
GAAACTCGCTA: AAACTCGCTA
GTGACGAGAAG: TGACGAGAAG
GGTTGTTTAGC: GTTGTTTAGC
TCATTGATCAC: CATTGATCAC
ACAGAGAGACT: CAGAGAGACT
CATGAAATGTC: ATGAAATGTC
CTGTATGCCAT: TGTATGCCAT
TGCCACCTTAT: GCCACCTTAT
CACTAGTCCGG: ACTAGTCCGG
AAATAGCAAGG: AATAGCAAGG
GGCCGCGCCCC: GCCGCGCCCC
GTGCCTGCGTT: TGCCTGCGTT
GCAAGGTACAC: CAAGGTACAC
CCGAAGCTGCA: CGAAGCTGCA
ATTGATGTCTG: TTGATGTCTG
GGAGTTTGGTT: GAGTTTGGTT
GAGGGACTGGT: AGGGACTGGT
ATAATCTCCTG: TAATCTCCTG
GGCACGGACAG: GCACGGACAG
CCCGTTGACAG: CCGTTGACAG
TAGACACGAGA: AGACACGAGA
CACTAGCCCTT: ACTAGCCCTT
ATAGTTAGTTA: TAGTTAGTTA
CCCCACCTGCA: CCCACCTGCA
GGAAATAGCAA: GAAATAGCAA
GGGGCAGACGG: GGGCAGACGG
TCAAAGGGGCT: CAAAGGGGCT
TCCCTCATACC: CCCTCATACC
AGTAATCCGGC: GTAATCCGGC
TTAATCTGTCA: TAATCTGTCA
ACTGAATCCGC: CTGAATCCGC
CCACTAGTCCG: CACTAGTCCG
TTGATGTCTGG: TGATGTCTGG
TCCAGTCGACC: CCAGTCGACC
AAGCTTTGCCG: AGCTTTGCCG
ATCATCGTAGT: TCATCGTAGT
CGGTAAGCTTT: GGTAAGCTTT
AGACAAGGATC: GACAAGGATC
GGGGAAGAAGG: GGGAAGAAGG
TCTCGAGGAAG: CTCGAGGAAG
GAAGAGTCGCG: AAGAGTCGCG
GACGAGAAGGG: ACGAGAAGGG
TGTCCCAAGGT: GTCCCAAGGT
ATTTAAAATAT: TTTAAAATAT
TCTGCTTGGTT: CTGCTTGGTT
AAAACTGAATC: AAACTGAATC
CACTGCCCGTC: ACTGCCCGTC
AGCAACCGACA: GCAACCGACA
ATACGATATCG: TACGATATCG
AAGCCCCAAAA: AGCCCCAAAA
CAGCGAGTGGG: AGCGAGTGGG
TGAATCTACCG: GAATCTACCG
ACAACAGCTCG: CAACAGCTCG
GGCTTAGTCCG: GCTTAGTCCG
TTCGGGCGGCA: TCGGGCGGCA
ATGAAATGTCC: TGAAATGTCC
GAACTCGAGTT: AACTCGAGTT
GCTCTCGTAGG: CTCTCGTAGG
GTTGACAGGTT: TTGACAGGTT
GACAATGCTCA: ACAATGCTCA
TATCCTTAGTG: ATCCTTAGTG
ACCCGGTAGAT: CCCGGTAGAT
CCTCCGTTCAT: CTCCGTTCAT
CGATATCGGTG: GATATCGGTG
GTTACGTGTAG: TTACGTGTAG
ATGGACAATGC: TGGACAATGC
TGTAGGATCGG: GTAGGATCGG
GTCATTGATCA: TCATTGATCA
AATGGTCGGTC: ATGGTCGGTC
GAAATGTCCCA: AAATGTCCCA
TTAGCTCAGGT: TAGCTCAGGT
AGCTGTGATTG: GCTGTGATTG
GACAAGGATCA: ACAAGGATCA
ATACAGGGACC: TACAGGGACC
GGACCTTTCCC: GACCTTTCCC
CGATCATCTTA: GATCATCTTA
TAAAGTGCCTG: AAAGTGCCTG
CGTAGTCTCGG: GTAGTCTCGG
TGGGGGCAGAC: GGGGGCAGAC
AACCAAACAAG: ACCAAACAAG
AAAGGGGCTTA: AAGGGGCTTA
TTTTCGAATCG: TTTCGAATCG
CAGAGGGGCGC: AGAGGGGCGC
AATGTCCCAAG: ATGTCCCAAG
AGCGTGGCATG: GCGTGGCATG
TTTATGATGGA: TTATGATGGA
CATGTAGCCAT: ATGTAGCCAT
CTGTCCGCTTT: TGTCCGCTTT
ATACCCAGGCG: TACCCAGGCG
AGAATAACCAA: GAATAACCAA
GGGGTTGACGT: GGGTTGACGT
TGAATGGTGTG: GAATGGTGTG
GGGAAATAGCA: GGAAATAGCA
ATCTGACCCCG: TCTGACCCCG
AGGGTCCTGGG: GGGTCCTGGG
GCCCACTAGTC: CCCACTAGTC
AAATGGTCGGT: AATGGTCGGT
TCCAGCGAGAC: CCAGCGAGAC
CATAATGAAAT: ATAATGAAAT
TTCCATTGATC: TCCATTGATC
CATCGTAGTCT: ATCGTAGTCT
TGCACCGCCCG: GCACCGCCCG
GAGCTTGAGTG: AGCTTGAGTG
ACTGCCATAAT: CTGCCATAAT
ACGGGGAAATA: CGGGGAAATA
CAGATCAAGAA: AGATCAAGAA
GCGCTATCGGT: CGCTATCGGT
GAGCTGTGATT: AGCTGTGATT
CGACAAGCCCA: GACAAGCCCA
GTAACGCATCA: TAACGCATCA
TTGCCGCAGAA: TGCCGCAGAA
ATCGTAGTCTC: TCGTAGTCTC
CACGAACTTCC: ACGAACTTCC
TTGAATAATAC: TGAATAATAC
CAAGCCCAACC: AAGCCCAACC
CCCCAGAGGGG: CCCAGAGGGG
CTGGAACTCGA: TGGAACTCGA
AATGAGAAGAC: ATGAGAAGAC
TCATACCGCAC: CATACCGCAC
GTGCGCCAGGT: TGCGCCAGGT
CATGCTTGACA: ATGCTTGACA
GACGGGGAAAT: ACGGGGAAAT
GCAGCGTCTTG: CAGCGTCTTG
ATTACAGAGAG: TTACAGAGAG
GGCACCGCCTT: GCACCGCCTT
TATTATAACCT: ATTATAACCT
GCGTGGCATGC: CGTGGCATGC
AACTCTCGGTC: ACTCTCGGTC
AATCCGCCAAA: ATCCGCCAAA
CCTGAGACAAG: CTGAGACAAG
CTGAGACAAGG: TGAGACAAGG
GAATGAGAAGA: AATGAGAAGA
TAGAATAACCA: AGAATAACCA
CCATGGCCCAC: CATGGCCCAC
CCCTCATACCG: CCTCATACCG
TCGATCTCTTC: CGATCTCTTC
CATCTTATTTA: ATCTTATTTA
CCAGCAAAATA: CAGCAAAATA
CGGAGTGACGA: GGAGTGACGA
AGGTAGAGCTA: GGTAGAGCTA
CCCAGCGAGTG: CCAGCGAGTG
TGTCCGCTTTT: GTCCGCTTTT
AACGTCCGCGC: ACGTCCGCGC
GGGCCAAATCT: GGCCAAATCT
GGACCAAAATG: GACCAAAATG
ATGGAACGGCC: TGGAACGGCC
CTAGTCCGGAT: TAGTCCGGAT
CCTGCGTTCAC: CTGCGTTCAC
GTTGACGTACA: TTGACGTACA
GCCTGCAAATG: CCTGCAAATG
TTGACAGGTTC: TGACAGGTTC
GCGCGCCAGTG: CGCGCCAGTG
CAAGTGGTCGA: AAGTGGTCGA
GCCTTGGACCT: CCTTGGACCT
ATGGTGTGCGC: TGGTGTGCGC
CCAACCTTCAA: CAACCTTCAA
TGCAGCTGTCA: GCAGCTGTCA
CTTAGAATAAC: TTAGAATAAC
CAGCCTTCCAG: AGCCTTCCAG
TCCAGAGTATC: CCAGAGTATC
GAAGCTATTAT: AAGCTATTAT
TATTTAAAATA: ATTTAAAATA
GAGACAAGGAT: AGACAAGGAT
GATTTAGGGCA: ATTTAGGGCA
AAGGCCCAGCG: AGGCCCAGCG
CAGGGACCCGG: AGGGACCCGG
GTGCCACTCCA: TGCCACTCCA
AAGTGCCTGCG: AGTGCCTGCG
GCCCGACAGCC: CCCGACAGCC
GACCATCCAGA: ACCATCCAGA
CCACATTAGCA: CACATTAGCA
CGATGACCAAA: GATGACCAAA
TATCGGTCATT: ATCGGTCATT
AGGTAGTTTAT: GGTAGTTTAT
TGTGCGCCAGG: GTGCGCCAGG
GAGAGAGAATT: AGAGAGAATT
ACTAGTCCGGA: CTAGTCCGGA
ACAGACTACCG: CAGACTACCG
GGTCAGTTCGG: GTCAGTTCGG
GAAGACTATTG: AAGACTATTG
ACGAACCAGCA: CGAACCAGCA
GTCCGGATACT: TCCGGATACT
ATCTCTTCATG: TCTCTTCATG
CTGAGGTCTCG: TGAGGTCTCG
GAATAATACGA: AATAATACGA
GCGTCTTGCAG: CGTCTTGCAG
AACGCGCCGTG: ACGCGCCGTG
GAGTTCCTTTT: AGTTCCTTTT
TCGGGCGGCAG: CGGGCGGCAG
CCGACGACCTG: CGACGACCTG
GCGCCTCGATC: CGCCTCGATC
CGTTCCAAACT: GTTCCAAACT
TTGACGGAGTC: TGACGGAGTC
GACGGAGTCAT: ACGGAGTCAT
AAGCTGCAGAC: AGCTGCAGAC
ATAATACGATA: TAATACGATA
CCCTCGCCCAG: CCTCGCCCAG
TCGAGTTTATG: CGAGTTTATG
CTCGGGGTTGA: TCGGGGTTGA
AATAGTTAGTT: ATAGTTAGTT
AACGTGTAGGA: ACGTGTAGGA
TTTCCGATCAC: TTCCGATCAC
AATCCTTAGCT: ATCCTTAGCT
AAAACGTGTAG: AAACGTGTAG
CACCTTCATGA: ACCTTCATGA
GAGAATTTTCG: AGAATTTTCG
TCCTTTTGTAA: CCTTTTGTAA
TCGGGCTCCTG: CGGGCTCCTG
AGAAGACTATT: GAAGACTATT
TTTTATCTCGA: TTTATCTCGA
GGGTTACGTGT: GGTTACGTGT
TCATGCTTGAC: CATGCTTGAC
AGAACAGGAAG: GAACAGGAAG
GACAGACTACC: ACAGACTACC
CATGGCCCACT: ATGGCCCACT
TGTTTAGCGAT: GTTTAGCGAT
CGGACTTAGAA: GGACTTAGAA
CGGTCCCTCAT: GGTCCCTCAT
GAATCCGCCAA: AATCCGCCAA
TGATGGACGGG: GATGGACGGG
AAGAGTCGCGG: AGAGTCGCGG
TGGTTGAATGG: GGTTGAATGG
CAGGGTCCTGG: AGGGTCCTGG
CACGAGAGGGG: ACGAGAGGGG
GCCATAATCTC: CCATAATCTC
TCAAACTCAAG: CAAACTCAAG
CACCGGGTCTA: ACCGGGTCTA
GGACAATGCTC: GACAATGCTC
GTTTAGGAGTT: TTTAGGAGTT
TTAGAATAACC: TAGAATAACC
CGTAGCTGGAA: GTAGCTGGAA
GTCCCTCATAC: TCCCTCATAC
GGAGTCATAAT: GAGTCATAAT
ATCACCCCACC: TCACCCCACC
CCTGGGACGAA: CTGGGACGAA
TAACCAAACAA: AACCAAACAA
GACAAGCCCAA: ACAAGCCCAA
CCCAAACATAC: CCAAACATAC
ACACGAGAGGG: CACGAGAGGG
CAGACTACCGT: AGACTACCGT
TCTCCGTCGAA: CTCCGTCGAA
AATTTATGATG: ATTTATGATG
TTGAATGGTGT: TGAATGGTGT
ATCTTAAAAAC: TCTTAAAAAC
CGAGACCATCC: GAGACCATCC
GCTGTCAAGGA: CTGTCAAGGA
AGATCAAGAAA: GATCAAGAAA
CGTAGGGGCAC: GTAGGGGCAC
CACCGCCTTGG: ACCGCCTTGG
CGCTATCGGTC: GCTATCGGTC
AGAAACTCGCT: GAAACTCGCT
AGGAAGATTAA: GGAAGATTAA
TACCCCGGGTT: ACCCCGGGTT
GCGAGACCATC: CGAGACCATC
CCAAAACGTGT: CAAAACGTGT
CCGTTGACAGG: CGTTGACAGG
CGTTCGATTGC: GTTCGATTGC
GCTGGAACTCG: CTGGAACTCG
TCCGCTTTTCG: CCGCTTTTCG
ACGAGAGGGGT: CGAGAGGGGT
AGGGGCTTAGT: GGGGCTTAGT
CTTTTTAGGCT: TTTTTAGGCT
GTCTACGGGCC: TCTACGGGCC
CTTGACACCTT: TTGACACCTT
TCTGACGTCCA: CTGACGTCCA
GCTTGGTTGAA: CTTGGTTGAA
ACCCTCGGGGT: CCCTCGGGGT
TCAGGTTAGAG: CAGGTTAGAG
TCGAACGTCCG: CGAACGTCCG
GTTATAGACGG: TTATAGACGG
CGGACAGACTA: GGACAGACTA
AGCGAGCTGTG: GCGAGCTGTG
CGGGACGAGGA: GGGACGAGGA
CGCCTCGATCT: GCCTCGATCT
AGCGAGTGGGA: GCGAGTGGGA
CAAACATACTA: AAACATACTA
CGATTTAGGGC: GATTTAGGGC
GGCGGGCCAAA: GCGGGCCAAA
AGGTTCTGCGC: GGTTCTGCGC
ATTGTATGTGC: TTGTATGTGC
ATATCGGTGTA: TATCGGTGTA
ACCCCGGGCCC: CCCCGGGCCC
GGGCAGCGTCT: GGCAGCGTCT
TTGCAGGGACC: TGCAGGGACC
TTTTGGACTCC: TTTGGACTCC
TCTCGATGACC: CTCGATGACC
TGATATCTGCA: GATATCTGCA
ACCTAATATTT: CCTAATATTT
AGACACGAGAG: GACACGAGAG
TCCTTAGTGTA: CCTTAGTGTA
GGTTTTATCTC: GTTTTATCTC
GGGAGGTCGAT: GGAGGTCGAT
ACGAGTGCAGT: CGAGTGCAGT
CTCCCAAACAT: TCCCAAACAT
CGCGGCCTGTG: GCGGCCTGTG
ACTGGTCGATT: CTGGTCGATT
AAGTTCAGCCT: AGTTCAGCCT
CAGCGAGACCA: AGCGAGACCA
GTGAGAGAGAA: TGAGAGAGAA
GATCATCTTAT: ATCATCTTAT
TCGGTCATTGA: CGGTCATTGA
CCCACTTCTGC: CCACTTCTGC
TATCTGCAGTA: ATCTGCAGTA
ACCGGGTCTAC: CCGGGTCTAC
GAGGGCTACTG: AGGGCTACTG
AGGGGCACCCT: GGGGCACCCT
TGTGAGGTAGA: GTGAGGTAGA
CCCGACAGCCT: CCGACAGCCT
CAATCATGTAG: AATCATGTAG
TTGATAACGTT: TGATAACGTT
ATCACAAAGAA: TCACAAAGAA
ACCAAAACGTG: CCAAAACGTG
CTAATATTTCC: TAATATTTCC
TGCAGTCGTCC: GCAGTCGTCC
GAATTTTAGGG: AATTTTAGGG
GACCTAGACCC: ACCTAGACCC
TAGCCCTTTTA: AGCCCTTTTA
ATTAGTGACAG: TTAGTGACAG
ACTCGCTAAGA: CTCGCTAAGA
CCGCCCGTTCG: CGCCCGTTCG
CTGCGTTCACT: TGCGTTCACT
CTCAAGTGGTC: TCAAGTGGTC
ACCACATTAGC: CCACATTAGC
CGGATTCCATT: GGATTCCATT
TCCCTCGCCCA: CCCTCGCCCA
GGTCCCTCATA: GTCCCTCATA
ATACCGCACTA: TACCGCACTA
TTTAGGAGTTT: TTAGGAGTTT
AGAGAGACTAG: GAGAGACTAG
CGGATTCTCCG: GGATTCTCCG
TGGAACTCGAG: GGAACTCGAG
TCGGTCGAGAC: CGGTCGAGAC
GAGTATCGGGC: AGTATCGGGC
GGGACGAACCA: GGACGAACCA
AGACGGTCAAA: GACGGTCAAA
CTTGCAGGGAC: TTGCAGGGAC
TCCGTCGAACG: CCGTCGAACG
GATCTCCGTCG: ATCTCCGTCG
GGTAAAGTGCC: GTAAAGTGCC
CAGCGTCTTGC: AGCGTCTTGC
TTGGTTGTTTA: TGGTTGTTTA
CTGGACCTTTC: TGGACCTTTC
AATCTGACGAA: ATCTGACGAA
GTCCCGAAGCT: TCCCGAAGCT
ACTCCAATAGT: CTCCAATAGT
CAATTAATCTG: AATTAATCTG
CGGTCGGAGGG: GGTCGGAGGG
TTCCAAACTCG: TCCAAACTCG
GCCTTCCAGCG: CCTTCCAGCG
CGCCCGACAGC: GCCCGACAGC
AGCTGCAGACC: GCTGCAGACC
GACCTGTCCGC: ACCTGTCCGC
TCAAGTGGTCG: CAAGTGGTCG
GACTACCGTGT: ACTACCGTGT
GCGCTTTTTAG: CGCTTTTTAG
ATGTAAGAAGA: TGTAAGAAGA
AGGAAGTGAGA: GGAAGTGAGA
TTCGACTGGAA: TCGACTGGAA
GCTATGCACCG: CTATGCACCG
ACCTTCATGAA: CCTTCATGAA
AGACGGTAAAG: GACGGTAAAG
GTAGAACCAAA: TAGAACCAAA
TCTTGTTCGGA: CTTGTTCGGA
CCGTCCGCCGC: CGTCCGCCGC
GGATTTTACCC: GATTTTACCC
TCAAGAAACTC: CAAGAAACTC
CAACTCATTTT: AACTCATTTT
GACGAGGACCT: ACGAGGACCT
GTAGGGGCACC: TAGGGGCACC
ATATGGAGCTT: TATGGAGCTT
TAGGATGGGGG: AGGATGGGGG
GCTTGACACCT: CTTGACACCT
GACACCTTCAT: ACACCTTCAT
AGGGAGGTCGA: GGGAGGTCGA
TCGTAGTCTCG: CGTAGTCTCG
